################################
#A   #   #       #          # B#
#### # # # ##### # ### #### #  #
#      #   #     # #   #    # ##
## ########### ### ### ######  #
#  #        #          #    ## #
# ## ### ## ######## #    #    #
#  #  #   # #   #  # ###########
## #### # # # #    # #         #
#  #    # ### # #### # # ## ## #
# ## ####   # #      # # #   # #
# #     # # # ######## # ##### #
# # ##  # # #    #   # #       #
# # #  ## # #### # # # # #######
#   #  #  #        #   #      *#
################################
